####################
#__________________#
#__________________#
###########________#
#__________________#
#__________________#
#___#___#__##______#
#_________##########
#__________________#
#__________________#
#__________________#
#________#_________#
#________#_________#
#______#####_______#
#________#_________#
#________#_________#
#__________________#
#__________________#
#__________________#
####################