#########################
#***********************#
#***********************#
#***********************#
#***********************#
#***********************#
#***********************#
#******###########******#
#***********************#
#***********************#
#***********************#
#***********************#
#******###########******#
#***********************#
#***********************#
#***********************#
#***********************#
#***********************#
#******##########*******#
#***********************#
#***********************#
#***********************#
#***********************#
#***********************#
#########################