####################
#__________________#
#__________________#
#____________#######
#__________________#
#__##______________#
#__##______________#
#__##______________#
#__________________#
#________#####_____#
#__________________#
#__________________#
######_____________#
#__________________#
#__________________#
#_____________###__#
#_____________##___#
#__#__________#____#
#__#_______________#
####################